************************
_**********************_
--*-**-****************.-
*********************.--
******-**********.-,****
**************.-********
******-*****************
=***-,*.-*******.-,*****
==****-*****************
==*************.---,****
===*********************
====*****************===
========================